R  1200 800
NO textures/1.xpm
SO textures/2.xpm
WE textures/3.xpm
EA textures/4.xpm
S  textures/sprite2.xpm
D  textures/bh_door.xpm
HUD textures/hud.xpm
DEAD textures/deadscreen.xpm
F  3,180,0
C  31,119,255

1111111111111111111111111111111111111111111111111111111111111111111111111111111111111111111111
1000000000000000000100000000000000000000000000000000000000000000000000000000000000000000000001
1000000000000000000100000000000000000000000000000000000000000000000000000000000000000000000001
1000000000000000000H00000000000000000000000000000000000000000000000000000000000000000000000001
1000000000000000000100000000010000000000000000000000000000000000000000000000000000000000000001
1000000000000000000100000000000000000000000000000000000000000000000000000000000000000000000001
111D11111D111111D11100000000000000000000000000000000000000000000000000000000000000000000000001
1000000000000000000000000000000000000000000000000000000000000000000000000000000000000000000001
1000000000000000000000000000000000000000000000000000000000000000000000000000000000000000000001
1000000000000000000000000000010000000000000000000000000000000000000000000000000000000000000001
1000000000000000000000000000010000000000000000000000000000000000000000000000000000000000000201
100000E0000000000002000000000D0000000000000000000000000000000000000000000000000000000000000001
10000000000000000000000000000D0000000000000000000000000000000000000000000000000000000000000001
1000000000000000000000000000010000000000000000000000000000000000000000000000000000000000000001
1000000000000000000000000000010000000000000000000000000000000000000000000000000000000000000001
1000000000000000000000000000000000000000000000000000000000000000000000000000000000000000000001
111D11111D111111D11100000000000000000000000000000000000000000000000000000000000000000000000001
1000000000000000000100000000000000000000000000000000000000000000000000000000000000000000000001
1000000000000000000100000000000000000000000000000000000000000000000000000000000000000000000001
1000000000000000000H00000000000000000000000000000000000000000000000000000000000000000000000001
1000000000000000000100000000000000000000000000000000000000000000000000000000000000000000000001
1000000000000000000100000000000000000000000000000000000000000000000000000000000000000000000001
1111111111111111111111111111111111111111111111111111111111111111111111111111111111111111111111