R  500 500
NO textures/1.xpm
SO textures/2.xpm
WE textures/3.xpm
EA textures/4.xpm
S  textures/sprite2.xpm
D  textures/bh_door.xpm
HUD textures/hud.xpm
DEAD textures/deadscreen.xpm
F  3,180,0
C  31,119,255


111111111111111111111111111111111111111
100000000000000000010000000000000000001
100000000000000000010000000000000000001
1000000000000000000H0000000000000000001
100000000000000000010000000000000000001
100000000000000000010000000000000000001
111D11111D111111D1110000000000000000001
100000000000000000000000000000000000001
100000000000000000000000000000000000001
100000000000000000000000000001000000001
100000000000000000000000000001000000001
100000E0000000000002000000000D000000001
10000000000000000000000000000D000000001
100000000000000000000000000001000000001
100000000000000000000000000001000000001
100000000000000000000000000000000000001
111D11111D111111D1110000000000000000001
100000000000000000010000000000000000001
100000000000000000010000000000000000001
1000000000000000000H0000000000000000001
100000000000000000010000000000000000001
100000000000000000010000000000000000001
111111111111111111111111111111111111111