R 1200 800
NO textures/trump.xpm
SO textures/urss.xpm
WE textures/volcan.xpm
EA textures/courgette.xpm
S textures/sprite.xpm
D textures/bh_door.xpm
HUD textures/hud.xpm
DEAD textures/deadscreen.xpm
F 80,80,80
C 126,5,0

1111111111111111111111111111111111111111111
1000000000000000000000000000000000000000001
1001000001001111001000100100000011000000001
1001100011010000100101000100011000100000001
1001010101011111100010000100000000100000001
1001001001010000100101000000011000100000001
1001000001010000101000100100000011000000001
1000000000000000000000000000000000000000001
1000000000000000000000000000000000000000001
1000000000000000000000000000000000000000001
1000000000000000000000000000000000000000001
100000000000000000000000000000111111H111111
1000000000N0000000000000000000D000000000001
100000000000000000000000000000D000000000001
111111111D1D1111111111111H11111000000000001
1000000000100000000010000000000000000000001
1000000000H00000000010000000000000000002001
1000000000100000000010000000000000000000001
1000020000100002000010000000000000000000001
1111111111111111111111111111111111111111111