R  1200 800
NO textures/1.xpm
SO textures/2.xpm
WE textures/3.xpm
EA textures/4.xpm
S  textures/sprite2.xpm
D  textures/bh_door.xpm
HUD textures/hud.xpm
DEAD textures/deadscreen.xpm
F  3,180,0
C 31,119,255

11111111111111111111111111111111111111111111111111111111111111111111111111111111111111111111111
10000000000000000001000000000000000000000000000000000000000000000000000000000000000000000000001
10000000000000000001000000000000000000000000000000000000000000000000000000000000000000000000001
1000000000000000000H000000000000000000000000000000000000000000000000000000000000000000000000001
10000000000000000001000000000100000000000000000000000000000000000000000000000000000000000000001
10000000000000000001000000000000000000000000000000000000000000000000000000000000000000000000001
111D11111D111111D111000000000000000000000000000000000000000000000000000000000000000000000000001
10000000000000000000000000000000000000000000000000000000000000000000000000000000000000000000001
10000000000000000000000000000000000000000000000000000000000000000000000000000000000000000000001
10000000000000000002000000000100000000000000000000000000000000000000000000000000000000000000001
10000E00000000000000000000000100000000000000000000000000000000000000000000000000000000000002001
10000000000000000002000000000D00000000000000000000000000000000000000000000000000000000000000001
10000000000000000000000000000D00000000000000000000000000000000000000000000000000000000000000001
10000000000000000000000000000100000000000000000000000000000000000000000000000000000000000000001
10000000000000000000000000000100000000000000000000000000000000000000000000000000000000000000001
10000000000000000000000000000000000000000000000000000000000000000000000000000000000000000000001
111D11111D111111D111000000000000000000000000000000000000000000000000000000000000000000000000001
10000000000000000001000000000000000000000000000000000000000000000000000000000000000000000000001
1000000000000000000H000000000000000000000000000000000000000000000000000000000000000000000000001
11111111111111111111111111111111111111111111111111111111111111111111111111111111111111111111111
