R 1000 800
NO textures/autorouteduBH.xpm
SO textures/LGBT.xpm
WE textures/ok.xpm
EA textures/xd.xpm
S path_to_the_sprite_texture
F 3,180,0
C 31,119,255

11111111111111111111
10000000000000000001
10000000000000000001
10000000111100000001
10000000000000000001
10000001011010000001
10000000000000000001
10000000111100000001
10E00000000000000001
10000000000000000001
11111111111111111111
